3,1,1,1,1,4,6,3,1,1,1,4
3,1,1,1,1,4,6,3,1,1,1,4
3,1,1,1,1,4,6,3,1,1,1,4
3,1,1,1,1,4,6,3,1,1,1,4
3,1,1,1,1,4,6,3,1,1,1,4
3,1,1,1,1,4,6,3,1,1,1,4
3,1,1,1,1,4,6,3,1,1,1,4
3,1,1,1,1,4,6,3,1,1,1,4
3,1,1,1,1,4,6,3,1,1,1,4
3,1,1,1,1,4,6,3,1,1,1,4
3,2,2,2,2,4,6,3,2,2,2,4
0,0,0,0,0,0,6,0,0,0,0,0
