0,0,0,0,14,0,0,0,0,0,0
7,1,1,4,14,7,1,1,1,1,1
3,1,1,4,14,3,1,1,1,1,1
3,1,1,4,14,3,1,1,1,1,1
3,1,1,4,14,3,1,1,1,1,1
3,1,1,4,14,3,1,1,1,1,1
3,1,1,4,14,3,1,1,1,1,1
3,1,1,4,14,3,1,1,1,1,1
3,1,1,4,14,3,1,1,1,1,1
3,1,1,4,14,3,1,1,1,1,1
3,1,1,4,14,3,1,1,1,1,1
3,1,1,4,14,3,1,1,1,1,1
3,1,1,4,14,3,1,1,1,1,1
5,2,2,12,14,3,1,1,1,1,1
0,17,13,13,16,3,1,1,1,1,1
0,14,0,0,0,1,1,1,1,1,1
0,14,0,7,1,1,1,1,1,1,1
0,14,0,5,2,2,2,2,2,2,2
