0,0,0,0,0,15,0,0,0,0,0
0,0,18,14,14,17,0,1,0,0,0
0,0,29,1,1,1,1,1,0,1,0
0,0,29,14,19,1,0,0,1,0,0
0,0,29,1,15,1,28,0,0,0,0
0,0,29,0,16,14,28,1,0,15,0
0,1,15,1,1,0,15,1,0,15,0
0,1,16,19,0,1,15,0,1,15,0
0,1,1,15,1,21,28,14,14,17,0
0,1,1,15,1,21,28,1,0,0,0
0,1,2,15,0,21,20,14,1,1,0
0,1,13,16,14,19,0,0,1,1,0
0,0,0,0,0,15,0,0,0,0,0
